//MAP CONVERTED BY dmm2tgm.py THIS HEADER COMMENT PREVENTS RECONVERSION, DO NOT REMOVE
"a" = (
/obj/structure/chair/wood{
	dir = 1
	},
/turf/open/floor/holofloor/grass,
/area/template_noop)
"f" = (
/obj/structure/window/reinforced/spawner/directional/south,
/obj/item/banner/red,
/turf/open/floor/holofloor/asteroid,
/area/template_noop)
"g" = (
/obj/structure/window/reinforced/spawner/directional/south,
/obj/item/banner/blue,
/turf/open/floor/holofloor/asteroid,
/area/template_noop)
"j" = (
/obj/machinery/door/window/left/directional/south,
/turf/open/floor/holofloor/grass,
/area/template_noop)
"k" = (
/obj/structure/table/wood/fancy,
/obj/item/clothing/suit/armor/riot/knight/blue,
/obj/item/clothing/head/helmet/knight/blue,
/turf/open/floor/holofloor/grass,
/area/template_noop)
"p" = (
/turf/open/floor/holofloor/asteroid,
/area/template_noop)
"r" = (
/obj/structure/table/wood,
/obj/item/scythe,
/obj/item/spear,
/obj/item/melee/chainofcommand{
	name = "chain whip"
	},
/turf/open/floor/holofloor/asteroid,
/area/template_noop)
"t" = (
/obj/machinery/door/window/right/directional/south,
/turf/open/floor/holofloor/grass,
/area/template_noop)
"x" = (
/turf/open/floor/holofloor/grass,
/area/template_noop)
"y" = (
/obj/structure/table/wood,
/obj/item/melee/chainofcommand{
	name = "chain whip"
	},
/obj/item/spear,
/turf/open/floor/holofloor/asteroid,
/area/template_noop)
"B" = (
/turf/open/floor/holofloor{
	icon_state = "stairs-old"
	},
/area/template_noop)
"C" = (
/obj/structure/table/wood/fancy,
/obj/item/clothing/head/costume/crown/fancy{
	pixel_y = 6
	},
/turf/open/floor/holofloor/grass,
/area/template_noop)
"E" = (
/obj/structure/window/reinforced/spawner/directional/south,
/turf/open/floor/holofloor/asteroid,
/area/template_noop)
"H" = (
/obj/structure/statue/diamond/captain,
/turf/open/floor/holofloor/grass,
/area/template_noop)
"I" = (
/obj/machinery/door/window/left/directional/south,
/turf/open/floor/holofloor/asteroid,
/area/template_noop)
"J" = (
/obj/structure/window/reinforced/spawner/directional/south,
/turf/open/floor/holofloor/grass,
/area/template_noop)
"N" = (
/obj/structure/table/wood,
/obj/item/spear,
/turf/open/floor/holofloor/asteroid,
/area/template_noop)
"Q" = (
/obj/structure/table/wood/fancy,
/obj/item/clothing/suit/armor/riot/knight/blue,
/obj/item/clothing/head/helmet/knight/blue,
/obj/item/claymore/weak,
/turf/open/floor/holofloor/grass,
/area/template_noop)
"X" = (
/obj/structure/table/wood,
/obj/item/scythe,
/obj/item/spear,
/turf/open/floor/holofloor/asteroid,
/area/template_noop)

(1,1,1) = {"
H
J
N
p
p
p
p
g
x
a
"}
(2,1,1) = {"
x
J
r
p
p
p
p
E
x
a
"}
(3,1,1) = {"
k
t
B
p
p
p
p
E
x
a
"}
(4,1,1) = {"
Q
J
y
p
p
p
p
I
x
a
"}
(5,1,1) = {"
C
J
X
p
p
p
p
E
x
a
"}
(6,1,1) = {"
Q
J
N
p
p
p
p
I
x
a
"}
(7,1,1) = {"
k
j
B
p
p
p
p
E
x
a
"}
(8,1,1) = {"
x
J
y
p
p
p
p
E
x
a
"}
(9,1,1) = {"
H
J
N
p
p
p
p
f
x
a
"}
